5
24 6
1 2 2 2 2 2 30 30 1 2 2 2 2 2 30 30 30 30 30 30 9 14 14 18 
3 4 3 3 3 3 2 2 3 4 3 3 3 3 2 2 2 2 2 2 11 12 13 19 
4 5 4 4 4 4 4 4 4 5 4 4 4 4 4 4 4 4 5 5 20 15 13 18 
6 7 5 6 6 5 6 5 6 7 5 6 6 5 6 5 5 5 7 0 8 16 17 10
22 23 24 22 22 24 22 24 22 23 24 22 22 24 22 24 24 25 23 26 27 28 29 21 
0 0 0 0 0 0 0 0 0 0 0 0 0 0 0 0 0 0 0 0 0 0 0 0
[TileSetID
[map's Width] [map's Height]
[24 6 
[TileMap under Matrix representation]
[1 2 2 2 2 2 30 30 1 2 2 2 2 2 30 30 30 30 30 30 9 14 14 18
[3 4 3 3 3 3 2 2 3 4 3 3 3 3 2 2 2 2 2 2 11 12 13 19 
[4 5 4 4 4 4 4 4 4 5 4 4 4 4 4 4 4 4 5 5 20 15 13 18
[6 7 5 6 6 5 6 5 6 7 5 6 6 5 6 5 5 5 7 0 8 16 17 10
[22 23 24 22 22 24 22 24 22 23 24 22 22 24 22 24 24 25 23 26 27 28 29 21
[0 0 0 0 0 0 0 0 0 0 0 0 0 0 0 0 0 0 0 0 0 0 0 0
