5
24 6
0 1 1 1 1 1 29 29 0 1 1 1 1 1 29 29 29 29 29 29 8 13 13 17 
2 3 2 2 2 2 1 1 2 3 2 2 2 2 1 1 1 1 1 1 10 11 12 18 
3 4 3 3 3 3 3 3 3 4 3 3 3 3 3 3 3 3 4 4 19 14 12 17 
5 6 4 5 5 4 5 4 5 6 4 5 5 4 5 4 4 4 6 -1 7 15 16 9
21 22 23 21 21 23 21 23 21 22 23 21 21 23 21 23 23 24 22 25 26 27 28 20 
-1 -1 -1 -1 -1 -1 -1 -1 -1 -1 -1 -1 -1 -1 -1 -1 -1 -1 -1 -1 -1 -1 -1 -1 -1
[TileSetID
[map's Width] [map's Height]
[24 6 
[TileMap under Matrix representation]
[1 2 2 2 2 2 30 30 1 2 2 2 2 2 30 30 30 30 30 30 9 14 14 18
[3 4 3 3 3 3 2 2 3 4 3 3 3 3 2 2 2 2 2 2 11 12 13 19 
[4 5 4 4 4 4 4 4 4 5 4 4 4 4 4 4 4 4 5 5 20 15 13 18
[6 7 5 6 6 5 6 5 6 7 5 6 6 5 6 5 5 5 7 0 8 16 17 10
[22 23 24 22 22 24 22 24 22 23 24 22 22 24 22 24 24 25 23 26 27 28 29 21
[0 0 0 0 0 0 0 0 0 0 0 0 0 0 0 0 0 0 0 0 0 0 0 0
