9
16 6
97 106 107 97 -1 -1 97 -1 97 -1 5 116 117 -1 5 70
54 49 116 88 -1 -1 89 -1 5 -1 5 49 116 117 5 70
88 90 90 98 -1 -1 88 -1 104 -1 104 90 90 105 104 70
97 92 92 97 99 96 97 101 97 101 97 96 102 92 97 108
91 93 93 91 93 95 112 100 112 100 112 95 112 93 104 103
94 94 94 94 94 94 94 94 94 94 94 94 94 94 98 94
[TileSetID
[map's Width] [map's Height]
[TileMap under Matrix representation]