9
88 5
0 5 8 9 2 5 8 9 2 5 84 9 2 5 8 9 17 5 8 11 2 2 2 2 5 83 12 5 1 2 2 17 5 11 5 11 5 11 5 2 11 2 1 1 2 12 5 40 45 51 49 54 51 56 56 56 62 51 62 49 49 56 56 71 2 0 5 1 2 5 11 2 5 8 76 77 78 79 5 81 78 79 5 81 78 84 11 43
1 5 7 11 2 5 15 11 2 5 8 11 2 5 15 11 1 5 15 12 2 2 2 20 4 16 30 31 32 2 2 1 5 12 5 12 5 12 5 9 12 2 2 20 35 13 4 41 45 50 49 55 49 49 47 47 62 63 5 49 51 49 49 41 3 73 31 20 2 5 12 2 5 7 1 2 5 80 5 77 5 80 5 82 5 83 12 40
2 5 6 12 2 5 7 12 9 5 15 12 2 5 7 12 2 5 15 12 2 20 18 22 27 28 29 27 33 34 3 35 5 12 5 12 5 12 5 17 12 2 18 22 28 28 85 42 46 65 65 27 49 52 48 57 104 64 104 49 66 67 68 69 72 28 85 33 34 31 13 35 31 109 2 2 5 2 5 2 5 2 5 17 5 6 86 41
2 5 2 12 9 5 6 12 17 5 7 12 2 5 6 12 0 5 7 110 21 22 23 25 5 2 1 5 26 27 23 23 5 12 5 12 5 12 5 38 110 21 19 39 2 2 5 43 45 48 48 54 65 58 61 48 -1 -1 97 65 58 61 50 70 83 2 5 26 23 27 29 27 29 33 34 2 5 2 5 2 5 2 5 1 5 18 22 42
3 4 3 13 10 4 3 13 14 4 16 13 3 4 3 13 14 4 16 18 19 24 10 3 4 3 3 4 3 4 10 10 4 13 4 13 4 13 4 10 18 19 14 10 3 3 4 44 45 52 49 55 48 4 60 59 -1 -1 55 111 4 60 59 70 16 3 4 3 10 4 14 4 14 75 74 34 4 3 4 3 4 3 4 3 4 87 24 44
[TileSetID
[map's Width] [map's Height]
[TileMap under Matrix representation]
